30 30
13 1
15 25
333333333333333333333333333333
333333333333333333333333333333
333333333333333333333333333333
333333333333333333333333333333
330005500033000550003333333333
330114411033011441103333333333
330105501033010550103333333333
330103301033545335453377777773
330103301033545335453377777773
330103301033545335453377777773
330103301033545335453377777773
330103301033545335453377777773
000103301033545335453377777773
011103301033545335453377777773
000003301033545335453377777773
333333301033545335453377767773
333333301033545335453333545333
330000001033545330103333545333
330111111033545330103333545333
330100000033545330103333545333
330103333333545330103333545333
330103333333545330103333545333
330103333333545330103333545333
330103333333545330103333545333
330105555555010330103333545333
330114444444110330100000010333
330005555555000330111111110333
333333333333333330000000000333
333333333333333333333333333333
333333333333333333333333333333