30 30
28 1
8 24
000555555550003333333777777733
011444444441103333333777777733
010555555550103333333777777733
010333333330103333333777777733
010300055550103333333777777733
010301144441103333333777777733
010301055550003333333777777733
010354533333333333333777777733
010354533333333333333777677733
010354533333333333333335453333
010354533333333333333335453333
010354533333333333333335453333
010354533000555500033335453333
010354533011444411033335453333
010354533010555501033335453333
010354533545333301033335453333
010354533545333301033335453333
010354533545333301033335453333
010354533545333301033335453333
010354533545333301033335453333
010354533545333301033335453333
010354533545333301033335453333
010301000010333301033335453333
010301111110333301033335453333
010300000000333301033335453333
010333333333333301033335453333
010333333333333301033335453333
010333333333333301055550103333
010333333333333301144441103333
000333333333333300055550003333
