9 13
1111111000000
1000200000000
1111111111111
2000000020001
1111111111111
1000200000002
1111111111111
2002000200001
1111111111111