11 13
0 6
10 0
0000001111111
0000000000001
1111111111111
1000200000000
1111111111111
2000000020001
1111111111111
1000200000002
1111111111111
2002000200001
1111111111111